6
6
224131413141
313141314151
514351413531
314434543144
444444345434
123152423111