7
7
23314131414114
41314131415141
31314131414131
31414131314131
41313131414151
51415151313141
12413131413111